AFG=Afghanistan
ALB=Albania
ALG=Algeria
ASA=American Samoa
AND=Andorra
ANG=Angola
ANT=Antigua & Barbuda
ARG=Argentina
ARM=Armenia
ARU=Aruba
AUS=Australia
AUT=Austria
AZE=Azerbaijan
BAH=Bahamas
BRN=Bahrain
BAN=Bangladesh
BAR=Barbados
BLR=Belarus
BEL=Belgium
BIZ=Belize
BEN=Benin
BER=Bermuda
BHU=Bhutan
BOL=Bolivia
BIH=Bosnia-Herzegovina
BOT=Botswana
BRA=Brazil
IVB=British Virgin Is.
BRU=Brunei
BUL=Bulgaria
BUR=Burkina Faso
BDI=Burundi
CAM=Cambodia
CMR=Cameroon
CAN=Canada
CPV=Cape Verde
CAY=Cayman Islands
CAF=Central African Rep.
CHA=Chad
CHI=Chile
CHN=China
TPE=Chinese Taipei
COL=Colombia
COM=Comoros
CGO=Congo
COK=Cook Islands
CRC=Costa Rica
CRO=Croatia
CUB=Cuba
CYP=Cyprus
CZE=Czech Republic
PRK=DPR Korea
COD=Dem. Rep. of  Congo
DEN=Denmark
DJI=Djibouti
DMA=Dominica
DOM=Dominican Republic
ECU=Ecuador
EGY=Egypt
ESA=El Salvador
GEQ=Equatorial Guinea
ERI=Eritrea
EST=Estonia
ETH=Ethiopia
FAR=Faroe Islands
FIJ=Fiji
FIN=Finland
MKD=Fr. Yug. Rep. Macedonia
FRA=France
GAB=Gabon
GAM=Gambia
GEO=Georgia
GER=Germany
GHA=Ghana
GIB=Gibraltar
GBR=Great Britain
GRE=Greece
GRN=Grenada
GUM=Guam
GUA=Guatemala
GUI=Guinea
GBS=Guinea-Bissau
GUY=Guyana
HAI=Haiti
HON=Honduras
HKG=Hong Kong
HUN=Hungary
IRI=I. R. Iran
ISL=Iceland
IND=India
INA=Indonesia
IRQ=Iraq
IRL=Ireland
ISR=Israel
ITA=Italy
CIV=Ivory Coast
JAM=Jamaica
JPN=Japan
JOR=Jordan
KAZ=Kazakhstan
KEN=Kenya
KIR=Kiribati
KOR=Korea
KUW=Kuwait
KGZ=Kyrgyzstan
LAO=Laos PDR
LAT=Latvia
LIB=Lebanon
LES=Lesotho
LBR=Liberia
LBA=Libya
LIE=Liechtenstein
LTU=Lithuania
LUX=Luxembourg
MAC=Macau
MAD=Madagascar
MAW=Malawi
MAS=Malaysia
MDV=Maldives
MLI=Mali
MLT=Malta
MIL=Marshall Islands
MTN=Mauritania
MRI=Mauritius
MEX=Mexico
FSM=Micronesia
MDA=Moldova
MON=Monaco
MNE=Montenegro
MGL=Mongolia
MAR=Morocco
MOZ=Mozambique
MYA=Myanmar
NAM=Namibia
NRU=Nauru
NEP=Nepal
NED=Netherlands
AHO=Netherlands Antilles
NZL=New Zealand
NCA=Nicaragua
NIG=Niger
NGR=Nigeria
NMA=Northern Mariana Islands
NOR=Norway
OMA=Oman
PAK=Pakistan
PLW=Palau
PLE=Palestine
PAN=Panama
PNG=Papua New Guinea
PAR=Paraguay
PER=Peru
PHI=Philippines
POL=Poland
POR=Portugal
PUR=Puerto Rico
QAT=Qatar
ROU=Romania
RUS=Russia
RWA=Rwanda
STP=S. Tome & Principe
LCA=Saint Lucia
SAM=Samoa
SMR=San Marino
KSA=Saudi Arabia
SEN=Senegal
SRB=Serbia
SEY=Seychelles
SLE=Sierra Leone
SIN=Singapore
SVK=Slovakia
SLO=Slovenia
SOL=Solomon Islands
SOM=Somalia
RSA=South Africa
ESP=Spain
SRI=Sri Lanka
SKN=St. Kitts & Nevis
VIN=St. Vincent & Grenadines
SUD=Sudan
SUR=Suriname
SWZ=Swaziland
SWE=Sweden
SUI=Switzerland
SYR=Syria
TAH=Tahiti
TJK=Tajikistan
TAN=Tanzania
THA=Thailand
TLS=Timor-Leste
TOG=Togo
TGA=Tonga
TRI=Trinidad &Tobago
TUN=Tunisia
TUR=Turkey
TKM=Turkmenistan
UGA=Uganda
UKR=Ukraine
UAE=United Arab Emirates
USA=United States
URU=Uruguay
UZB=Uzbekistan
VAN=Vanuatu
VEN=Venezuela
VIE=Vietnam
ISV=Virgin Islands
YEM=Yemen
ZAM=Zambia
ZIM=Zimbabwe
